###############################
#                             #
#                             #
#                             
#           S ##               
#          + ##               
#                             #
#                             #
#                             #
###############################