##############################
#                            #
#                            #
#           #                 
#  #       GJ##               
#+$#       JS##               
# #         #                #
#                            #
#                            #
##############################