###############################
#                             #
#                             #
#           #                 
#  #       GJ##               
#+$#       JS##               
# #         #                 #
#                             #
#                             #
###############################