################################################################
#                            +++                               #
                            #S+S#
#                            +++                               #
################################################################