################################################################
#                            +++                               #
                            #S$S#
#                            +++                               #
################################################################