####################################     ######################
#															  #
#														J	  #
#															  #
#															  #
#															  #
#															  #
#															  #
#															  #
#		J													  #
 															  #
#															  #
#															  #
#															  #
#															  #
#															  #
#															  #
#															  #
#				  ####################						  #
#				 ##					 #						  #
#				##		S	S		 ##%#					  #
#				#	G		++$	G	S 	#					  #
#				#	S		+++			#					  #
#				#			+&++	S	#					  #
#				#		GS	+++		G	#					   
#				#				S		#					  #
#				#%%##		S		   ##					  #
#					##################%#					  #
#															  #
#															  #
#										                      #
###############################################################