##### #####
#OOOO OOOO#
#OOOO OOOO#
#OOOO OOOO#
#OOOOJOOOO#
    J+J    
#OOOOJOOOO#
#OOOO OOOO#
#OOOO OOOO#
#OOOO OOOO#
##### #####