#######  #######
#######  #######
######    ######
#####      #####
####  OOOO  ####
###  OOOOOO  ###
##  OOOOOOOO  ##
   OOOOOOOOOO   
   OOOOOOOOOO  
##  OOOOOOOO  ##
###  OOOOO   ###
####  OOOO  ####
#####      #####
######    ######
#######  #######
#######  #######