##  ####  ##
#++++##++++#
 +%++  ++++ 
 ++++  ++++ 
#++++##++++#
##  ####  ##
##  ####  ##
#++++##++++#
 ++++  +%++ 
 ++++  ++++ 
#++++##++++#
##  ####  ##