#######  #######
#######  #######
######    ######
#####      #####
####        ####
###          ###
##            ##
                
                
##            ##
###          ###
####        ####
#####      #####
######    ######
#######  #######
#######  #######