# ##############################################################
#                                                              #
#########%#################################################### #
########+++#                                                 # #
########+++# ############################################### # #
########+++# #                                             # # #
#########%## # #############                               # # #
#########    #             #                         S +   # # #
######### #######%######## #                         G+    # # #
######### #######JJJ###### #                         G +   # # #
######### #######JJJ###### #                         S+    # # #
######### #########%###### #                               # # #
#####                      #                               # # #
#####G                     % ############################### # #
########################## #                                 # #
##########                 ################################### #
########## ######## ######                                     
########## ######## ############################################
########   ######## ############################################
#######  # ######## ############################################
######  ## ########                                            #
#####  ### ################################################### 
####  #### ################################################### #
###  ##### ################################################### #
##  ###### #######################                             #
## ####### ######################        $  ###             ## #
## ####### #####################           S### G          ### #
## ####$## ####################             ###          ##### #
## ##J% ## ################                             ###### #
## #### ## ##############   ################################## #
##   ## ## #############   ################################### #
####    ## ############   #################################### #
####### ## ###########   ##################################### #
####### ## ##########   ###################################### #
####### ## #########   ####################################### #
####### ## ########   ######################################## #
####### ## #######   ######################################### #
####### ## ######   ########################################## #
####### ##     %   ########################################### #
####### ## ################################################### #
####### ##                                  ################## #
####### ################################### ################## #
####### ###############################+++% ################## #
####### ###############################+$+# ################## #
####### ###############               %+++# ################## #
####### ##############  ################### ################## #
####### #############  #################### ################## #
####### ############  ##################### ################## #
####### ###########  ###################### ################## #
####### ##########  ####################### ##############JJJ% #
####### #########  ######################## ##############JJJ# #
####### ########  ######################### ##############JJJ#
####### #######  ########################## ##############%### #
####### ######  ####                                           #
####### #####  ##### ###########################################
#######JJJ##  ###### ###########################################
#######JJJ#  ####### ###########################################
#######JJJ%          ###########################################
#################### ###########################################
#################### ###########################################
#################### ###########################################
#################### ###########################################
####################
################################################################