# ##############################################################
#                                                              #
#########%#################################################### #
#++++++#+++#                                                 # #
#      #+++# ############################################### # #
#  G   #+++# #                                             # # #
#      ##%## # #############                               # # #
#   J  ##    #             #                         S +   # # #
#      ## #######%######## #                         G+    # # #
#      ## #######JJJ###### #                         G +   # # #
#      ## #######JJJ###### #                         S+    # # #
# ####### #########%###### #                               # # #
#                          #                               # # #
## ##G                     % ############################### # #
## #########################                                 # #
## #######                 ################################### #
## ####### ######## ######                                     
## ####### #  G+  # ############################################
## #####   #      # ############################################
## ####  # # J  J # ############################################
## ###  ## #                                                   #
## ##  ### ################################################# # 
## #  #### #####   ###                                       # #
##   ##### ####     ## ####################################### #
##  ###### ###   &   #       #####                             #
## ####### ####     #  ##### ####        $  ###             ## #
## ####### #####   #  ###### ###           S### G          ### #
## ####$## ######%#  ####### ##             ###          ##### #
## ##J% ## #####    #######                             ###### #
## #### ## ##### ########   ################################## #
##   ## ## ##### #######   ################################### #
## #    ## ##### ######   #################################### #
## #### ## ##### #####   ##################################### #
## #### ## ##### ####   ###################################### #
## #### ## ##### ###   ####################################### #
## #### ## ##### ##   ######################################## #
## #### ## ##### #   ######################################### #
## #### ## #####    ########################################## #
## #### ##     %   ########################################### #
## #### ## ################################################### #
## #### ##                                  ################## #
## #### ################################### ################## #
## #### ###############################+++% ################## #
## #### ###############################+$+# ################## #
## #### ###############               %+++# ################## #
## #### ##############  ############# ##### ################## #
## #### #############  ##                 # ################## #
## #### ############  ###  ##  +      ##  # ################## #
## #### ###########  ####                 # ################## #
## #### ##########  #####         S       # ##############JJJ% #
## #### #########  ######  ##         ##  # ##############JJJ# #
## #### ########  #######     J           # ##############JJJ#
## #### #######  ########################## ##############%### #
## #### ######  ####                                           #
## #### #####  ##### ######################################### #
## ####JJJ##  ###### #                     G                   #
## ####JJJ#  ####### #                 S                       #
## ####JJJ%          # #########################################
## ######## ######## #                                         #
#+           G###### ######################################### #
#### ############### %                                         #
### S ############## ###########################################
### +$##############
################################################################