# #############################
#                              
# ########################### #
# #          J+$  +       % # #
# #         SG## $        # # #
# #%####################### # #
# %                         # #
############################# #
#                             #
# #############################