# #############################
#                              
# ########################### #
# #          J+   +       % # #
# #         SG## $        # # #
# #%####################### # #
# %                         # #
############################# #
#                             #
# #############################