###############################
#                             #
#                             #
#                             #
#            ##               #
#            ##               #
#                             #
#                             #
#                             #
###############################